#################################
#                     E         #
#             #####             #
#      #                 #      #
#          #         #          #
#          #         #          #
O      #   #   ###   #   #      #
#          #         #          #
#          #         #          #
#      #                 #      #
#             #####             #
#     C                         #
################O################ 