#################################
#                               #
#                               #
#                               #
#                               #
#                               #
#                               O
#                               #
#                               #
#                               #
#                               #
#                               #
################O################