#################################
#                               #
#             #####             #
#      #                 #      #
#          #         #          #
#          #         #          #
#      #   #   ###   #   #      O
#          #         #          #
#          #         #          #
#      #                 #      #
#             #####             #
#                               #
################O################