################O################
#    E                   C      #
#     #  ## #  ###  # ##  #     #
#     #    C              #     #
#         #  ##   ## #          #
#  #  ###               ###  #  #
O  #          #   #          #  #
#  #  ###C              ###  #  #
#         #  ##   ## #          #
#     #                   #     #
#     #  ## #  ###  # ##  #     #
#                               #
################O################ 