################O################
#        #             #        #
# # #  # # #M####### # #E#  # # #
#   #         J #      C   C#   #
# ###   # # # # # # # # #   ### #
#     #      E E          #     #
O #####                   ##### O
#     #                   #     #
# ###   # # # #C# #C# # #   ### #
#   #           #           #   #
# # #  # # # ####### # # #  # # #
#      C #             #        #
################O################ 