################O################
#   E    #             #        #
# #E#  # # # ####### # #E#  # # #
#  J#           #      C E C#   #
# ###   # # # # # # # # #   ### #
#    E#                   #     #
O #####        M   P      ##### O
#     #                   #     #
# ###   # # # #C# #C# # #   ### #
#   #           #           #   #
# # #  # # # ####### # # #  # # #
#      C #             #        #
################O################ 