################O################
#                               #
#             #####             #
#      #                 #      #
#       E  #         #          #
#          #         #          #
O      #   #   ###   #   #      #
#          #         #          #
#          #      C  #          #
#      # EE E    E       #      #
#             #####             #
#                               #
################################# 