################O################
#                               #
#     #  ## # C###  # ##  #     #
#     #                   #     #
#         #  ##   ## #  C       #
#  #  ###               ###  #  #
#  #          #   #   E      #  O
#  #  ###               ###  #  #
#         #  ##   ## #E         #
#     #     E       E     #  C  #
#C    #  ## #  ###  # ##  #     #
#                               #
################O################ 