################O################
#                               #
#                               #
#                               #
#                               #
#                               #
O                               #
#                               #
#                               #
#                               #
#                               #
#                               #
#################################