################O################
#                               #
#                               #
#                               #
#                               #
#                               #
#                               O
#                               #
#                               #
#                               #
#                               #
#                               #
#################################