#################################
#                      C        #
#    C  #####  ###  #####       #
#    #      #       #      #    #
#       #     #####     #       #
#    #                 E   #    #
O       #               #       O
#    #                     #    #
#       #     #####E    #       #
#    #      # E     #      #    #
#       #####  ###  #####   C   #
#               J               #
################O################ 