#################################
#                               #
#                               #
#                               #
#                               #
#                               #
O                               O
#                               #
#                               #
#                               #
#                               #
#                               #
################O################