#################################
#                     C         #
#             #####             #
#      #                 #      #
#          #         #          #
#          #         #       C  #
#      #   #   ###   #   #      O
#          #         #          #
#          #         #          #
#      #                 #      #
#             #####             #
#                   E           #
################O################ 