################O################
#        #             #E       #
# # #  # # # ####### # # #  # # #
#   #        E E# E    CE  C#   #
# ###   # # # # # # # # #   ### #
#     #                   #     #
O #####        M          ##### O
#     #                   #     #
# ###   # # # #C# #C# # #   ### #
#   #           #           #   #
# # #  # # # ####### # # #  # # #
#      C #             #        #
################O################ 