#####################
#                   #
#                   #
#                   #
#                   #
O                   O
#                   #
#                   #
#                   #
#                   #
##########O##########