################O################
#                               #
#                               #
#                               #
#                               #
#                               #
O                               O
#                               #
#                               #
#                               #
#                               #
#                               #
#################################