################O################
#        #             #        #
# # #  # # # ####### # # #  # # #
#   #           #E       E  #   #
# ###   # # # #E# # # # #   ### #
#     #                   #     #
O #####                   #####JO
#     #                   #     #
# ###   # # # #C# #C# # #   ### #
#   #           #           #   #
# # #  # # # ####### # # #  # # #
#        #           E #        #
################O################ 