################O################
#        #             #EE      #
# # #  # # #M####### # # #  # # #
#   #           #      CE  C#   #
# ###   # # # # # # # # #   ### #
#     #       M           #     #
O #####         J         ##### O
#     #                   #     #
# ###   # # # #C# #C# # #   ### #
#   #           #           #   #
# # #  # # # ####### # # #  # # #
#      C #     E       #        #
################O################ 