#################################
#                      C        #
#    C  #####  ###  #####       #
#    #      #       #      #    #
#       #     #####     #       #
#    #                     #    #
O       #               #       O
#   C#                     #    #
#       #     ##### E   #       #
#    #      #       #     E#    #
#       #####  ###  #####   C   #
#                      E        #
################O################ 