################O################
#        #             # #      #
# # #  # # #M####### # # #  # # #
#   #           #      C  EC#   #
# ###   # # # # # # # # #  E### #
#     #       M  E        #     #
O #####                   ##### O
#     #                   #     #
# ###   # # # #M# #C# # #   ### #
#   #          E#           #   #
#C# #  # # # ####### # # #  # # #
#      C #             #        #
################O################ 