################O################
#                     C         #
#       #####  ###  #####       #
#    #      #       #     C#    #
#       #     #####     #       #
#    #         E           #    #
O       #               #       O
#    #                     #    #
#      C#     #####     #       #
#    #      #       #      #    #
#       #####  ###  #####       #
#                               #
################################# 