##########O##########
#                   #
#                   #
#                   #
#                   #
O                   O
#                   #
#                   #
#                   #
#                   #
#####################