################O################
#                               #
#             #####     E       #
#      #                 #      #
#          #      C  #   E      #
#      C   #        E#          #
#      #   #   ##    #   #      O
#          #         #     E    #
#          #         #          #
#  C   #       E         #      #
#             #####             #
#      C                        #
################################# 