#################################
#                               #
#  C          #####             #
#      #     E           #      #
#          #  E      #    C     #
#          #  EJ     #          #
O      #  E#M  ###   #   #     C#
#          #         #          #
#          #        C#          #
#      #                 #      #
#             #####             #
#     C                         #
################O################ 