##########O##########
#                   #
#                   #
#                   #
#                   #
O                   #
#                   #
#                   #
#                   #
#                   #
##########O##########