################O################
#   J                 C         #
#       #####  ###  #####       #
#    #      #       #     C#    #
#     E #     #####  C  #       #
#    #E                    #    #
O       #             C #       O
#   E# E                   #    #
#       #     #####     #       #
#    # E    #       #      #    #
#       #####  ###  #####       #
#                               #
################################# 