#################################
#                               #
#                               #
#                               #
#                               #
#                               #
O                               #
#                               #
#                               #
#                               #
#                               #
#                               #
################O################