################O################
#        #             # E      #
# # #  #E# #M####### # #E#  # # #
#   #      E    #      CE  C#   #
# ###   # # #J# # # # # #   ### #
#     #       M           #     #
O #####       E M         ##### O
#     #                   #     #
# ###   # # # #C# #C# # #   ### #
#   #           #           #   #
# # #  # # # ####### # # #  # # #
#      C #             #        #
################O################ 