#####################
#                   #
#                   #
#                   #
#                   #
#                   O
#                   #
#                   #
#                   #
#                   #
##########O##########